*************************
************************#
************************#
************************#
************************#
************************#
******############******#
************************#
************************#
************************#
************************#
******############******#
************************#
************************#
************************#
************************#
******############******#
************************#
************************#
************************#
************************#
******############******#
************************#
************************#
#########################
